4 4
+-+-+-+-+
|*      |
+       +
|       |
+       +
|    O  |
+       +
|       |
+-+-+-+-+
